Afrikaans: Hallo
Albanian: Përshëndetje
Amharic: ሰላም (pronounced "salam")
Arabic: مرحبا (pronounced "marhaba") 
Armenian: Բարև (pronounced "barev")
Azerbaijani: Salam
Basque: Kaixo
Bengali: নমস্কার (pronouncd "nomoshkar")
Bhutanese: Kuzu zangpo la
Bosnian: Zdravo
Bulgarian: Здравейте (pronounced "zdraveĭte") 
Burmese: ဟယ်လို (pronounced "hailo")
Cambodian/Khmer: ជំរាបសួរ (pronounced "chomreabsuor")
Cantonese Chinese: 哈囉 (pronounced "ha lo") 
Chichewa: Moni 
Croatian: Bok 
Czech: Ahoj
Danish: Hej
Dutch: Hallo
English: Hello 
Estonian: Tere 
Farsi/Persian: سلام (pronounced "salam")
Fijian: Bula 
Finnish: Hei 
French: Bonjour 
Georgian: გამარჯობა (pronounced "gamardjoba")
German: Hallo 
Greek: Γεια σας (pronounced "geia sas") 
Hausa: Sannu 
Hawaiian: Aloha 
Hebrew: שלום (pronounced "shalom")
Hmong: Nyob zoo
Hungarian: Szia 
Icelandic: Halló
Igbo: Ndewo 
Indonesian: Halo 
Italian: Ciao
Japanese: こんにちは (pronounced "konnichiwa") 
Kannada: ಹಲೋ (pronounced "halo") 
Kazakh: Сәлеметсіз бе (pronounced "salemetsiz be") 
Khmu: ສະບາຍດີ (pronounced "sabaidee") 
Kinyarwanda: Muraho 
Kiribati: Moa oti 
Korean: 안녕하세요 (pronounced "annyeonghaseyo") 
Kyrgyz: Салам (pronounced "salam") 
Lao: ສະບາຍດີ (pronounced "sabaidee") 
Latvian: Sveiki 
Lithuanian: Sveiki 
Luganda: Wabula
Macedonian: Здраво (pronounced "zdravo")
Malagasy: Manao ahoana
Malay: Hai
Malayalam: നമസ്കാരം (pronounced "namaskaram")
Mandarin Chinese: 你好 (pronounced "nǐ hǎo")
Maori: Kia ora  
Marshallese: Yokwe
Mongolian: Сайн байна уу (pronounced "sain baina uu")
Ndebele: Sawubona
Nepali: नमस्ते (pronounced "namaste")
Norwegian: Hei
Nyanja: Moni
Oromo: Akkam
Polish: Cześć
Portuguese: Olá
Punjabi: ਸਤ ਸ੍ਰੀ ਅਕਾਲ (pronounced "sat sri akaal")
Romanian: Salut
Russian: Здравствуйте (pronounced "zdravstvuyte")
Samoan: Talofa
Serbian: Здраво (pronounced "zdravo")
Sesotho: Lumela (pronounced "dumela")
Setswana: Dumela
Shona: Mhoro
Sinhala: හෙලෝ (pronounced "helo")
Slovak: Ahoj
Slovenian: Živijo
Somali: Salaam alaykum
Spanish: Hola
Sranan Tongo: Odi
Swahili: Habari
Swati: Sawubona
Swedish: Hej 
Tagalog/Filipino: Kamusta
Tahitian: Ia ora na
Tajik: Салом (pronounced "salam")
Tamil: வணக்கம் (pronounced "vanakkam")
Telugu: నమస్తే (pronounced "namaste")
Thai: สวัสดี (pronounced "sawatdee")
Tigrinya: ሰላም (pronounced "salam")
Tongan: Mālō e lelei
Turkish: Merhaba
Turkmen: Salam
Ukrainian: Вітаю (pronounced "vitayu")
Urdu: سلام (pronounced "salam")
Uzbek: Salom
Vietnamese: Xin chào
Wolof: Salam
Xhosa: Molo
Xitsonga: Avuxeni
Yoruba: Bawo ni
Zulu: Sawubona